10 10
..........
.o#....#..
.....O.#..
..#...111.
..#..11#1.
...#.1#...
.o...1.#..
o#o#.1#...
111111..#.
....#.....
8 0
9 0
