10 10
.....#....
.......#..
...#..#o..
..#....#..
....o.....
....#.....
....o..#..
..o...#...
..#.....##
......#o..
9 0
0 1
